 #   ###
 # #
 # # ###
 # #####
   #   #
## # #
 # # # #
     #/#